Justice League (Core): Barry Allen, Batman
Justice League (Extended): Aquaman, Barry Allen, Bart Allen, Batman, Black Canary, Black Lightning, Booster Gold, Captain Marvel Jr., Captain Marvel
Justice League (film): Aquaman, Barry Allen, Batman
Justice League Founder: Aquaman, Barry Allen
Justice League Unlimited: Batman
Justice League International: Booster Gold

Justice Society of America (Core): Alan Scott
Justice Society of America (Extended): Alan Scott

Young Justice (Core): Bart Allen
Young Justice (Extended): Amethyst, Bart Allen

Teen Titans (Extended): Bart Allen, Captain Marvel Jr.
Teen Titans (Core): Beast Boy
Teen Titans Go! Cast: Beast Boy

Birds of Prey (Core): Barbara Gordon, Black Canary
Birds of Prey (Extended): Barbara Gordon, Black Canary

Doom Patrol (Extended): Beast Boy

Green Lantern Corps: Alan Scott

Bat-Family (Core): Alfred Pennyworth, Barbara Gordon, Batman
Bat-Family (Extended): Alfred Pennyworth, Barbara Gordon, Batman

Legion of Superheroes (Core): Brainiac 5

Survivors of the First Crisis (DC Comics): Alexander Luthor Jr.

Arrowverse Main Cast: Barry Allen
Outsiders: Batman, Black Lightning
Flash Family: Barry Allen, Bart Allen
The Rogues (Flash): Captain Boomerang
Shazam Family: Captain Marvel Jr., Captain Marvel
Stardew Valley Trio: Abigail
Stardew Valley Bachelorettes: Abigail
Stardew Valley Bachelors: Alex
Stardew Valley Residents: Abigail, Alex
Avengers (Core): Black Panther, Captain America
Avengers (Extended): Agent Venom, Beast, Black Panther, Captain America, Captain Britain
USAvengers: Cannonball
Guardians of the Galaxy (Extended): Adam Warlock, Agent Venom
Champions (Marvel) (Core): Amadeus Cho
Young Avengers (Extended): America Chavez
X-Men First Class: Angel, Beast
X-Men (Extended): Angel, Anole, Armor, Aurora, Banshee, Beast, Blink, Cannonball
X-Men (Core): Beast
Young X-Men: Anole, Armor
Giant Sized X-Men #1 Team: Banshee
New Mutants (Core): Cannonball
New Mutants (Extended): Cannonball
Fantastic Four (Extended): Bentley-23, Black Panther
Future Foundation: Bentley-23
Exiles (Core): Blink
Infinity Watch: Adam Warlock
Symbiote Squad: Agent Venom
Hulks: Amadeus Cho
Ultimates (Team): America Chavez, Black Panther, Blue Marvel
Alpha Flight: Aurora
Falcon & the Winter Soldier Main Trio: Baron Zemo, Bucky Barnes
Captain Americas: Bucky Barnes
Invaders: Captain America
Avengers Original Quintet: Captain America
Band of Fools (Original): Akkar, Arthail Consumer of Food, Byllemura Ruby-Eye
Band of Fools (Redux): Arthail Consumer of Food, Byllemura Ruby-Eye
Original Three (Band of Fools): Arthail Consumer of Food
Zach Wiebe's Permutations: Akkar
Aarav Gupta's Permutations: Arthail Consumer of Food
Harrison Truscott's Permutations: Byllemura Ruby-Eye
Order of the Pheonix I: Albus Dumbledore
Order of the Pheonix II: Albus Dumbledore, Arthur Weasley, Bill Weasley
Hogwarts Professors: Albus Dumbledore
Weasley Family: Arthur Weasley, Bill Weasley
The Gaang: Aang
Avatars: Aang
Team Avatar (Korra): Asami Sato, Bolin
Sesame Street Residents: Abby Cadabby, Bert, Big Bird
The Muppet Show: Animal, Beaker
Electric Mayhem: Animal
Best Friends Squad: Adora, Bow
The Rebellion (She-Ra): Adora, Bow
The Princess Alliance: Adora, Bow
Jedi Order: Ahsoka Tano, Anakin Skywalker, Cal Kestis
501st Legion (Star Wars): Ahsoka Tano, Anakin Skywalker
Star Wars Droids: BB-8, C3PO
Star Wars Droid Duo: C3PO
Stinger Mantis Crew: Cal Kestis
Sith Lord: Darth Vader
Galactic Empire: Darth Vader
Sequel Trilogy Main Cast: BB-8
The Clone Wars Primary Trio: Ahsoka Tano, Anakin Skywalker
Original Trilogy Quintet: C3PO
Heroes of Olympus: Annabeth Chase
Greek Demigods (Rick Riordan): Annabeth Chase
Original Prophecy: Annabeth Chase
Trials of Apollo Crew: Apollo
Titans (Rick Riordan): Calypso
Floor 19: Alex Fierro
Norse Demigods (Rick Riordan): Alex Fierro, Blitzen
Magnus Chase First Quintet: Blitzen
Magnus Chase Ragnarok-Halting Gang: Blitzen
House of Life: Amos Kane
Twenty-First Nome: Amos Kane
Knights of Seiros: Alois, Byleth, Catherine
Black Eagles: Bernadetta, Byleth
Blue Lions: Annette, Byleth
Golden Deer: Byleth
Vault Hunters: Amara, Axton, Brick
Borderlands 1 Vault Hunters: Brick
Borderlands 2 Vault Hunters: Axton
Borderlands 3 Vault Hunters: Amara
Shortpacked! Store: Amazi-Girl
Dumbing of Age Main Cast: Amazi-Girl
Sonic the Hedgehog (Main Cast): Amy Rose
Resistance (Sonic): Amy Rose
Sonic the Hedgehog (Extended Cast): Amy Rose, Big the Cat, Blaze the Cat
NASA (The Martian): Annie Montrose, Bruce Ng
Ares III Mission Crew: Beth Johanssen
Fellowship of the Ring: Aragorn, Boromir
Thorin and Company: Bilbo Baggins
Pokemon Anime Kanto Trio: Ash Ketchum, Brock
Champions (Pokemon): Blue
Kanto Gym Leaders: Blue, Brock
Super Smash Bros: Banjo, Bayonetta, Bowser Jr., Bowser, Captain Falcon
Super Smash Bros DLC: Banjo
Paper Mario: The Origami King Cast: Bobby
Koopa Troopa: Bowser Jr., Bowser
Zeppeli Family: Caesar Anthonio Zeppeli
Battle Tendency Cast: Caesar Anthonio Zeppeli
Flynn-Fletcher Family: Candace Flynn
Phineas and Ferb Main Child Group: Baljeet Tjinder, Buford Van Stomm

Dracula Hunters: Abraham Van Helsing, Arthur Holmwood
SFPD (Monk): Adrian Monk
Final Fantasy VII Party: Aerith Gainsborough, Barret Wallace
High Five (Ready Player One): Akihide Karatsu
ENCOM: Alan Bradley
Einharjar (Magnus Chase): Alex Fierro
Eureka! Citizens: Allison Blake
Fans! Cast: Ally
Fans! Polyamorous Group: Ally
Resistance (Half-Life): Alyx
Suicide Squad (Core): Amanda Waller, Captain Boomerang
Suicide Squad (Extended): Amanda Waller, Captain Boomerang
Phantom Thieves of Hearts: Ann Takamaki
Frozen Quintent: Anna
Camp Half-Blood: Annabeth Chase, Apollo
League of Legends Champions: Aphelios
Friendship Main Squad (My Little Pony): Applejack
Until Dawn Cast: Ashley Brown
Finch Family: Atticus Finch
Atlantis Crew (Disney): Audrey Ramirez
The Backyardigans: Austin
Overwatch Heroes: Bastion
Ender's Jeesh: Bean
Original Four (KSP): Bill Kerman, Bob Kerman
Team RWBY: Blake Belladonna
Rat Creature Horde (Bone): Blue Stupid Rat Creature, Brown Stupid Rat Creature
Raya and the Last Dragon Crew: Boun
Legion of Superheroes (Extended): Brainiac 5
Valorant Agents: Breach, Brimstone
Straw Hat Pirates: Brook
Pequod Crew: Captain Ahab
Essex Crew: Captain George Pollard Jr.
C Company (Saving Private Ryan): Captain John H. Miller
Star Trek: The Original Series Crew: Captain Kirk
The Nautilus Crew: Captain Nemo
OSS|Cortez Family: Carmen Cortez